############
#.#.......##
#.#.....o.##
#.##..o....#
#..#o......#
#..#...###.#
#.o........#
#...p.t..o.#
############
