############
#..........#
#..#o..##..#
#..###.o#o.#
#....#.....#
####.p.....#
###o..###..#
#.....t....#
############
