############
#..........#
##...#o....#
#...###....#
#.#.o#..#o.#
####p..###.#
#.#o....#o.#
#.....t..#.#
############
