############
#.....##...#
#......#o#.#
#.#.#..o#..#
#.o#o..#.#.#
#.#.#......#
#..........#
#...t...p#.#
############
