############
####.....p.#
###..#o#...#
##....#o...#
#....#o#o..#
#...#...#..#
#.........##
#t.......###
############
