############
#........#o#
#....o.....#
#..........#
##o#.#..#.##
#.#o#..#o#.#
#..........#
#..#p.t.#..#
############
